8
........
...#....
..S#....
####....
........
.....##.
.....#G.
........
