8
........
...#....
..S#....
.###....
........
.....##.
.....#G.
........
