10
..........
.....#....
.....#....
....S#....
..####....
..........
..........
.......###
.......#G.
..........
